blockade = नाकाबंदी
admonition चेतावनी
mighty ताकतवर
vinegar = सिरका
deliberate = जानबूझकर
conviction = दृढ़ विश्वास
rotten = सड़ा हुआ
obsolete = अप्रचलित
Candidly = खुलकर

Patanhi@123


thence = वहाँ से
strictures = सख्ती
dystopian = मनहूस
cognition = अनुभूति
pursuit = काम
feeble = कमज़ोर
manliness = बहादुरपन


inference = निष्कर्ष, अनुमान


as time passed = जैसे - जैसे समय बीतता गया
clunky = भद्दा
with this = इस के साथ
the dreamer = कल्पनाओं में रहने वाला
existence = अस्तित्व, मौजूदगी

exclaim = चिल्लाना
to say something suddenly and loudly because you are surprised, angry, etc.
inception = आरंभ
ubiquitous = सर्वव्यापक, सर्वत्र वर्तमान
precursor = a person or thing that comes before somebody/something similar, especially something that develops from it or is influenced by it
पहले से ही विद्यमान तथा उसी से विकसित या प्रभावित; अग्र; पूर्ववर्ती

Over the years = पिछले कुछ वर्षों में